AAC	Mil
AAH	C
ABW	C
ACP	C
ACQ	C
ACU	C
ACX	C
AEG	C
AFB	Mil
AFP	Mil
AHC	C
AHK	C
AIN	C
AIO	Mil
AKC	C
APF	C
ASF	Mil
ASY	Mil
ATG	C
BAF	Mil
BBD	C
BCS	C
BDA	C
BET	C
BOX	C
BRH	C
BRS	Mil
CAO	C
CBB	C
CCC	C
CCO	C
CEF	Mil
CFT	C
CGF	C
CJT	C
CKK	C
CLM	C
CLU	C
CLX	C
CNT	C
CNV	Mil
CRG	C
CSB	C
CTJ	C
CTW	C
CVK	C
CWC	C
CXM	C
CYG	C
DAE	C
DAF	Mil
DAR	Mil
DCC	C
DEC	C
DHK	C
DHL	C
DHV	C
DHX	C
DNY	Mil
ECX	C
EDA	C
EEF	Mil
EFA	C
EFE	C
EGO	C
EIC	C
EXB	Mil
FAC	Mil
FAE	Mil
FAF	Mil
FAS	C
FAX	C
FDX	C
FET	C
FMY	Mil
FNF	Mil
FNY	Mil
FON	C
FQA	C
FRG	C
FRH	C
GAF	Mil
GAM	Mil
GBC	C
GBO	C
GCL	C
GCO	C
GEC	C
GGC	C
GHF	Mil
GJH	C
GKA	Mil
GLC	C
GLD	C
GLU	C
GNC	C
GNY	Mil
GOL	C
GSC	C
GTI	C
HAF	Mil
HEX	C
HKC	C
HNA	Mil
HRZ	Mil
HTK	C
HUF	Mil
HVK	Mil
HYC	C
HYT	C
IAM	Mil
ICL	C
ICV	C
IEI	Mil
IFC	Mil
IFF	C
JAE	C
JCH	C
JEC	C
JFE	C
JUC	C
KHA	C
KIW	Mil
KJD	Mil
KRC	Mil
KZU	C
LAF	Mil
LBF	Mil
LBO	C
LCO	C
LCR	C
LFR	C
LMG	Mil
LSV	Mil
LTG	C
LUT	C
LYB	C
LYC	C
LYF	Mil
MBR	Mil
MCX	C
MDF	C
MFD	C
MFR	C
MGC	C
MGW	C
MIX	C
MJN	Mil
MMI	Mil
MNB	C
MRD	C
MRS	C
MSA	C
MSN	C
MSX	C
MTN	C
NAB	C
NAC	C
NAF	Mil
NCA	C
NCL	C
NCR	C
NDF	Mil
NFC	C
NFL	C
NGR	Mil
NKA	C
NOW	Mil
NPT	C
NRN	Mil
NVY	Mil
NYB	Mil
OAN	C
OLC	C
OWT	C
PAC	C
PAT	Mil
PCG	C
PCT	Mil
PLF	Mil
PNY	Mil
POA	Mil
PON	Mil
PSW	C
QID	Mil
RAX	C
RCG	C
RCN	C
REX	C
RFF	Mil
RFR	Mil
RGD	C
RJZ	Mil
RLR	C
RMF	Mil
RNR	C
ROF	Mil
RRF	Mil
RRL	Mil
RSF	Mil
RTM	C
RUN	C
SAF	Mil
SAR	C
SBR	C
SCB	C
SEV	C
SFQ	C
SFR	C
SFT	C
SHQ	C
SLT	C
SNC	C
SOB	C
SOO	C
SQF	Mil
SUB	C
SUI	Mil
SUK	C
SWN	C
SXY	C
TAY	C
TCG	C
TDG	C
TFR	C
TMN	C
TRG	C
TSU	C
TTF	C
TTG	C
TUM	C
TUN	Mil
UAF	Mil
UCC	C
UCG	C
UPS	C
USR	Mil
VAS	C
VLA	C
VLN	C
VRB	C
VTG	C
VTS	C
WAC	C
WAM	C
WIS	C
WTN	Mil
XRC	C
